11111111
100000E1
10000001
1P000001
11111111