11111111
1C0000E1
10000001
1P000000
11111111