11111111
1C0001E1
10000111
1P000001
11111111