11111111
1C0000E1
100A0001
1P000001
11111111