11111111
1C000001
10000001
1P000001
11111111