11111111
1C0000E1
10000001
1P0000001
11111111