1111111
1C000E1
1001111
1P000C1
1111111