11111111111111111111
1C0100000100C1E00001
10000010010111001101
110111100C0001101101
100000111111000000C1
1C00001C000101101101
11110010010101001101
1P000000010001C00001
11111111111111111111